. . . . . . B . . G
. # # . B . # # # .
. # X . C . # # . .
. # # . # . # . . .
. . . . . # # # # .
. . C # . R . . # #
C B . . . . . # # .
. # # . X . B # . #
. . C . . . . . # .
P # # R # . . C . #