G . . # C # Z . # B 
. # . . . . . . . .
. C # . . # Z # # #
# . . # R # . . . Z
. . . . # B . # . #
# . # # B # # . . .
. . . . . # Z . # .
R . # . # . . . . #
# . # . . . # . . .
B . # Z # . . # . P
