C . . . Z . . B # P
# . # . # . # # # .
# . # . # . . . # .
# . Z . . . # . # .
# # # . # # # . . .
B # # . . . . Z # .
. R . . # . # # # .
# # # . . . # B Z .
C . . . # . # # # #
G . . R # . . Z . B
