B Z # . # Z . . # G
# . . . # . # . . .
. . # . . . # . # .
. # B # # . . C # .
R # . # . . # B # .
. . . . . # C # # Z
. # # # . # . . . .
. . # . Z # # B # .
# . . . # # Z # # .
P . # . . . . . . R 
