P . . . . # B # # .
. # # # . # . # . C
. # B # Z # . Z . #
. . . . . # . # . .
. # # # . . . # . #
R . . . . Z # # Z #
# # . # # . . . . #
# . . Z # R . # . .
# . # . # # . # # #
B C # . # B . . . G
