G . . X . . . . . .
. . . # # # . . . .
C . B . . # X # # .
. # B . C # # . # .
# R # # # # C C . .
# # # . . # . . . .
. . . # . . . . . .
# . . . # B . # # .
. . . # . # . # . .
# B . # . . R # C P