# . # . . . . . C P
B # # C . # . . . .
# # # # # B # . # C
. # # # . . . . # .
. # . # . . # # . .
. # . . # . # . # .
# R X . . # C . . .
. # # . # . C . . .
. B . . X # . B R .
G . . . . . . . . .