P . # . # . # B . .
. . . . . X . # B #
. # . R # . . C # #
. . B # . # . . . #
. C C # . . . X . C
. C # # R . # B . #
. # # . . . . # # #
. . . # # . # # . .
. # . # . # . . . #
. . . . . . . . . G